# Rivillä ensimmäinen sana on se, jolle korjausehdotuksia haetaan.
# Rivin loput sanat ovat joko kiellettyjä korjausehdotuksia (huutomerkki
# sanan alussa) tai vaadittuja korjausehdotuksia (ei huutomerkkiä sanan
# alussa).
# Sanojen järjestys rivillä vaikuttaa siten, että vaaditun korjausehdotuksen
# jälkeen tulevien sanojen on löydyttävä (tai ne eivät saa löytyä)
# korjausehdotuksista kyseisen sanan jälkeen.

[]
Annna	Anna
hkoira	!h-koira	koira
marko	!marko	Marko
keski-ranska	!keski-ranska	Keski-Ranska
kerros-talo	!kerros- talo	!kerros -talo	kerrostalo
kuormaauto	kuorma-auto
kuormaauto	kuorma auto
ras'an	!raa’an	raa'an
ras’an	!raa'an	raa’an
kuorma-audo	!kuorma‐auto	kuorma-auto
kuorma‐audo	!kuorma-auto	kuorma‐auto
23.24	23,24
etelä-afrikka	Etelä-Afrikka
natsi-saksa	natsi-Saksa
maara	määrä
horoskoppi	horoskooppi
mito	maito
saapsa	saapas
selsius	celsius
Hkan	Håkan
maksakast9ke	maksakastike
ka+akala	kapakala
katunuoksu	katujuoksu
kauheen	kauhean
alurrn	alueen
Sstami	Aatami
hyppoo	hyppii
showssa	show'ssa
# = Tavutusvihjeet =
kerrost­alo	kerrostalo # kerrost<SH>alo
# = Korjausehdotusten järjestys =
# Sijamuodon vaikutus
taulusda	taulussa	taulusta
# Yhdyssanan osien lukumäärän vaikutus
papueri	paperi	papuero
# Kirjainkoon vaikutus
lemo	emo	Lemi
# Generointijärjestyksen vaikutus
laata	lasta	laatta
varoittova	varoittava
pelassa	pelossa
koittakaa	koettakaa
touhoilut	touhuilut
arvontisävero	arvonlisävero
latotatanssit	latotanssit

[voikko.setIgnoreDot(True)]
koirra.	!koira	koira.

[voikko.setSuggestionStrategy(SuggestionStrategy.OCR)]
Män_sälä	Mäntsälä
horrelioosi	borrelioosi
baapa	haapa
h0usut	housut
se_atavarakaup_ias	sekatavarakauppias

# setIgnoreNumbers must not affect spelling suggestions, it is only for spell checking.
[voikko.setSuggestionStrategy(SuggestionStrategy.OCR) voikko.setIgnoreNumbers(True)]
h0usut	housut
